13 13 13 13 13 13 13 13 13 13 13 13 13 13 13 13 13 13 13 13 13 13 13 13 13 13 13 13 13 13 13 13 13 13 13 13 13 13 13 13 13 13 13 13 13 13 13 13 13 13
13 13 13 13 13 13 13 13 13 13 13 13 13 13 13 13 13 13 13 13 13 13 13 13 13 13 13 13 13 13 13 13 13 13 13 13 13 13 13 13 13 13 13 13 13 13 13 13 13 13
13 13 13 13 13 13 13 13 13 13 13 13 13 13 13 13 13 13 13 13 13 13 13 13 13 13 13 13 13 13 13 13 13 13 13 13 13 13 13 13 13 13 13 13 13 13 13 13 13 13
13 13 13 13 13 13 13 13 13 13 13 13 13 13 13 13 13 13 13 13 13 13 13 13 13 13 13 13 13 13 13 13 13 13 13 13 13 13 13 13 13 13 13 13 13 13 13 13 13 13
13 13 13 13 13 13 13 13 13 13 13 13 13 13 13 13 13 13 13 13 13 13 13 13 13 13 13 13 13 13 13 13 13 13 13 13 13 13 13 13 13 13 13 13 13 13 13 13 13 13
13 13 13 13 13 13 13 13 13 13 13 13 13 13 13 13 13 13 13 13 13 13 13 13 13 13 13 13 13 13 13 13 13 13 13 13 13 13 13 13 13 13 13 13 13 13 13 13 13 13
13 13 13 13 13 13 13 13 13 13 13 13 13 13 13 13 13 13 13 13 13 13 13 13 13 13 13 13 13 13 13 13 13 13 13 13 13 13 13 13 13 13 13 13 13 13 13 13 13 13
13 13 13 13 13 13 13 13 13 13 13 13 13 13 13 13 13 13 13 13 13 13 13 13 13 13 13 13 13 13 13 13 13 13 13 13 13 13 13 13 13 13 13 13 13 13 13 13 13 13
13 13 13 13 13 13 13 13 40 40 40 40 40 40 40 40 40 40 40 40 40 40 40 40 40 40 40 40 40 40 40 40 40 40 40 40 40 40 40 40 40 40 13 13 13 13 13 13 13 13
13 13 13 13 13 13 13 13 40 40 40 40 40 40 40 40 40 40 40 40 40 40 40 40 40 40 40 40 40 40 40 40 40 40 40 40 40 40 40 40 40 40 13 13 13 13 13 13 13 13
13 13 13 13 13 13 13 13 40 40 40 49 40 40 40 47 47 47 47 47 47 47 47 47 47 40 40 40 40 40 40 40 40 40 40 40 40 40 40 40 40 40 13 13 13 13 13 13 13 13
13 13 13 13 13 13 13 13 40 40 40 50 40 40 40 47 47 47 47 47 47 47 47 47 47 40 40 40 40 40 40 40 40 40 40 40 40 40 40 40 40 40 13 13 13 13 13 13 13 13
13 13 13 13 13 13 13 13 40 40 47 50 47 40 40 40 40 40 40 40 40 40 40 47 47 47 47 47 47 47 47 47 47 47 47 47 47 47 47 47 40 40 13 13 13 13 13 13 13 13
13 13 13 13 13 13 13 13 40 40 47 47 47 40 40 40 40 40 40 40 40 40 40 47 47 47 47 47 47 47 47 47 47 47 47 47 47 47 47 47 40 40 13 13 13 13 13 13 13 13
13 13 13 13 13 13 13 13 40 40 47 47 47 40 40 40 40 40 40 40 40 40 40 47 47 47 47 47 47 47 47 47 47 47 47 47 47 47 47 47 40 40 13 13 13 13 13 13 13 13
13 13 13 13 13 13 13 13 40 40 47 47 47 47 47 47 47 47 47 47 47 47 47 47 47 40 40 40 40 40 40 40 40 40 40 40 40 40 47 47 40 40 13 13 13 13 13 13 13 13
13 13 13 13 13 13 13 13 40 40 47 47 47 47 47 47 47 47 47 47 47 47 47 47 47 40 40 40 40 40 40 40 40 40 40 40 40 40 47 47 40 40 13 13 13 13 13 13 13 13
13 13 13 13 13 13 13 13 40 40 40 40 40 40 40 40 40 40 40 40 40 40 40 40 40 40 40 40 40 40 40 40 40 40 40 40 40 40 47 47 40 40 13 13 13 13 13 13 13 13
13 13 13 13 13 13 13 13 40 40 40 40 40 40 40 40 40 40 40 40 40 40 40 40 40 40 40 40 40 40 40 40 40 40 40 40 40 40 47 47 40 40 13 13 13 13 13 13 13 13
13 13 13 13 13 13 13 13 40 40 40 40 40 40 40 40 40 40 40 40 40 47 47 47 47 47 47 47 47 47 47 47 47 47 47 47 40 40 47 47 40 40 13 13 13 13 13 13 13 13
13 13 13 13 13 13 13 13 40 40 40 40 40 40 40 40 40 40 40 40 40 47 47 47 47 47 47 47 47 47 47 47 47 47 47 47 40 40 47 47 40 40 13 13 13 13 13 13 13 13
13 13 13 13 13 13 13 13 40 40 40 40 40 46 46 46 46 46 46 46 40 47 47 47 47 47 47 40 40 40 40 40 40 40 40 40 40 40 47 47 40 40 13 13 13 13 13 13 13 13
13 13 13 13 13 13 13 13 40 40 40 40 40 46 46 46 46 46 46 46 40 47 47 47 47 47 47 40 40 40 40 40 40 40 40 40 40 40 47 47 40 40 13 13 13 13 13 13 13 13
13 13 13 13 13 13 13 13 40 40 40 40 40 46 46 46 46 46 46 46 40 47 47 47 47 47 47 40 40 40 40 40 40 40 40 40 40 40 47 47 40 40 13 13 13 13 13 13 13 13
13 13 13 13 13 13 13 13 40 40 40 40 40 46 46 46 46 46 46 46 51 47 47 47 47 40 40 40 40 40 40 40 40 40 40 40 47 47 47 47 40 40 13 13 13 13 13 13 13 13
13 13 13 13 13 13 13 13 40 40 40 40 40 46 46 46 46 46 46 46 40 47 47 47 47 40 40 40 40 40 40 40 40 40 40 40 47 47 47 47 40 40 13 13 13 13 13 13 13 13
13 13 13 13 13 13 13 13 40 40 40 40 40 46 46 46 46 46 46 46 40 47 47 47 47 40 40 40 40 40 40 40 40 40 40 40 47 47 47 47 40 40 13 13 13 13 13 13 13 13
13 13 13 13 13 13 13 13 40 40 40 40 40 40 40 40 40 40 40 40 40 47 47 40 40 40 40 40 40 40 40 40 40 40 47 47 47 47 47 47 40 40 13 13 13 13 13 13 13 13
13 13 13 13 13 13 13 13 40 40 40 40 40 40 40 40 40 40 40 40 40 47 47 40 40 40 40 40 40 40 40 40 40 40 47 47 47 47 47 47 40 40 13 13 13 13 13 13 13 13
13 13 13 13 13 13 13 13 40 40 40 40 40 40 40 40 40 40 40 40 40 47 47 40 40 40 40 40 40 40 40 40 40 40 47 47 47 47 40 40 40 40 13 13 13 13 13 13 13 13
13 13 13 13 13 13 13 13 40 40 47 47 47 47 47 47 47 47 47 47 47 47 47 47 47 47 47 47 47 47 47 47 47 47 47 47 47 40 40 40 40 40 13 13 13 13 13 13 13 13
13 13 13 13 13 13 13 13 40 40 47 47 47 47 47 47 47 47 47 47 47 47 47 47 47 47 47 47 47 47 47 47 47 47 47 47 47 40 40 40 40 40 13 13 13 13 13 13 13 13
13 13 13 13 13 13 13 13 40 40 47 47 47 47 47 47 47 47 47 47 47 47 47 47 47 47 47 47 47 47 47 47 47 47 47 47 47 40 40 40 40 40 13 13 13 13 13 13 13 13
13 13 13 13 13 13 13 13 40 40 47 47 47 40 40 40 40 40 40 40 40 40 40 40 47 47 47 47 47 47 47 47 47 47 47 47 47 40 40 40 40 40 13 13 13 13 13 13 13 13
13 13 13 13 13 13 13 13 40 40 47 47 47 40 40 40 40 40 40 40 40 40 40 40 40 40 40 40 40 40 40 40 40 40 40 47 47 47 47 47 40 40 40 13 13 13 13 13 13 13
13 13 13 13 13 13 13 13 40 40 47 47 47 40 40 40 40 40 40 40 40 40 40 40 40 40 40 40 40 40 40 40 40 40 40 47 47 47 47 47 40 40 13 13 13 13 13 13 13 13
13 13 13 13 13 13 13 13 40 40 47 47 47 47 47 47 47 47 47 47 47 47 47 47 40 40 40 40 40 40 40 40 40 40 40 47 47 47 47 47 40 40 40 13 13 13 13 13 13 13
13 13 13 13 13 13 13 13 40 40 47 47 47 47 47 47 47 47 47 47 47 47 47 47 40 40 40 40 40 40 40 40 40 40 40 47 47 47 47 47 40 40 40 13 13 13 13 13 13 13
13 13 13 13 13 13 13 13 40 40 47 47 47 47 47 47 47 47 47 47 47 47 48 47 40 40 40 40 40 40 40 40 40 40 40 47 47 47 47 47 40 40 13 13 13 13 13 13 13 13
13 13 13 13 13 13 13 13 40 40 47 47 47 47 47 47 47 47 47 47 47 47 47 47 40 40 40 40 40 40 40 40 40 40 40 47 47 47 47 47 40 40 13 13 13 13 13 13 13 13
13 13 13 13 13 13 13 13 40 40 47 47 47 47 47 47 47 47 47 47 47 47 47 47 40 40 40 40 40 40 40 40 40 40 40 47 47 47 47 47 40 40 13 13 13 13 13 13 13 13
13 13 13 13 13 13 13 13 40 40 40 40 40 40 40 40 40 40 40 40 40 40 40 40 40 40 40 40 40 40 40 40 40 40 40 40 40 40 40 40 40 40 13 13 13 13 13 13 13 13
13 13 13 13 13 13 13 13 13 13 13 13 13 13 13 13 13 13 13 13 13 13 13 13 13 13 13 13 13 13 13 13 13 13 13 13 13 13 13 13 13 13 13 13 13 13 13 13 13 13
13 13 13 13 13 13 13 13 13 13 13 13 13 13 13 13 13 13 13 13 13 13 13 13 13 13 13 13 13 13 13 13 13 13 13 13 13 13 13 13 13 13 13 13 13 13 13 13 13 13
13 13 13 13 13 13 13 13 13 13 13 13 13 13 13 13 13 13 13 13 13 13 13 13 13 13 13 13 13 13 13 13 13 13 13 13 13 13 13 13 13 13 13 13 13 13 13 13 13 13
13 13 13 13 13 13 13 13 13 13 13 13 13 13 13 13 13 13 13 13 13 13 13 13 13 13 13 13 13 13 13 13 13 13 13 13 13 13 13 13 13 13 13 13 13 13 13 13 13 13
13 13 13 13 13 13 13 13 13 13 13 13 13 13 13 13 13 13 13 13 13 13 13 13 13 13 13 13 13 13 13 13 13 13 13 13 13 13 13 13 13 13 13 13 13 13 13 13 13 13
13 13 13 13 13 13 13 13 13 13 13 13 13 13 13 13 13 13 13 13 13 13 13 13 13 13 13 13 13 13 13 13 13 13 13 13 13 13 13 13 13 13 13 13 13 13 13 13 13 13
13 13 13 13 13 13 13 13 13 13 13 13 13 13 13 13 13 13 13 13 13 13 13 13 13 13 13 13 13 13 13 13 13 13 13 13 13 13 13 13 13 13 13 13 13 13 13 13 13 13
13 13 13 13 13 13 13 13 13 13 13 13 13 13 13 13 13 13 13 13 13 13 13 13 13 13 13 13 13 13 13 13 13 13 13 13 13 13 13 13 13 13 13 13 13 13 13 13 13 13
